XXXXXXXXX
XE______X
X_XXXX_oX
X_o____XX
XXX_X___X
X_o___X_X
X_XXX_X_X
X_____o_X
XXXXXXSXX